48 c7 c7 39 d9 1e 7e c3
00 00 00 00 00 00 00 00
00 00 00 00 00 00 00 00
00 00 00 00 00 00 00 00
00 00 00 00 00 00 00 00
00 00 00 00 00 00 00 00
00 00 00 00 00 00 00 00
08 64 67 55 00 00 00 00
60 18 40 00 00 00 00 00