48 c7 c7 50 64 67 55 c3
00 00 00 00 00 00 00 00
00 00 00 00 00 00 00 00
00 00 00 00 00 00 00 00
00 00 00 00 00 00 00 00
00 00 00 00 00 00 00 00
00 00 00 00 00 00 00 00
08 64 67 55 00 00 00 00
34 19 40 00 00 00 00 00
37 65 31 65 64 39 33 39
00 00 00 00 00 00 00 00