00 00 00 00 00 00 00 00
00 00 00 00 00 00 00 00
00 00 00 00 00 00 00 00
00 00 00 00 00 00 00 00
00 00 00 00 00 00 00 00
00 00 00 00 00 00 00 00
00 00 00 00 00 00 00 00
a5 1a 40 00 00 00 00 00
d2 19 40 00 00 00 00 00
e1 19 40 00 00 00 00 00
48 00 00 00 00 00 00 00
2e 1a 40 00 00 00 00 00
7a 1a 40 00 00 00 00 00
ce 1a 40 00 00 00 00 00
00 1a 40 00 00 00 00 00
d2 19 40 00 00 00 00 00
34 19 40 00 00 00 00 00
37 65 31 65 64 39 33 39
00 00 00 00 00 00 00 00